------------
-       +  -
-          -
-   -------- 
-   -    - -
-   -      - 
-   ---    -
-          -
-  * - -----
-    -     -
-    -    ^-
------------