----------
-        -
-        -
-   *    - 
-     *  -
-  *     - 
-  *     -
-        -
-  *     -
----------
