------------
-      % + -
- = -  -----
-   -  ----- 
-          -
-----      - 
-   ---    -
-  +^      -
-  * -%-----
-    -     -
-    -    ^-
------------