------------
-   ?  % + -
- = -  -----
-   -  ----- 
-          -
-----?     - 
-*  ---  ? -
-  ?       -
-    -%-----
-    -     -
-?   -    ^-
------------