------------
------------
------------
------------ 
-          -
-          - 
- ^   * +  -
-          -
------------
------------
------------
------------