------------
-          -
-          -
-          - 
-          -
-          - 
-          -
-          -
-  *?      -
-          -
-          -
------------