----------
-        -
-        -
-   *    - 
-     *  -
-  *     - 
-  *     -
-        -
-  *?    -
----------
